width: 40
height: 15
---
xxxxxxxxxxxxxxxxxxxxxxxxxxxxxxxxxxxxxxxx
x  *     O         S     x    m   v    x
x             v          x    *   *    x
x   v                   * x            x
x         s        xxxxxxx      O     sx
x     xxx *   xx                       x
x                            xxx       x
x    v        xxxxxxxxxx        x      x
x         *                    x   *   x
x      S    m          S     *  x      x
x  *            *                      x
x        O           v     m     O     x
x     xx     s        xs            v  x
x  P      *           x       *        x
xxxxxxxxxxxxxxxxxxxxxxxxxxxxxxxxxxxxxxxx
---
